15 25
11
B 10 3
S 8 14
C 1 1
C 8 7
C 4 12
C 1 18
C 11 23
C 3 24
C 6 6
C 13 20
C 14 8
0 0 0 1 0 0 1 0 0 0 0
0 0 1 1 1 0 0 1 1 0 0
0 1 0 0 1 1 0 0 0 0 0
1 1 0 0 0 0 0 0 0 1 0
0 1 1 0 0 0 0 1 0 0 0
0 0 1 0 0 0 0 1 0 0 1
1 0 0 0 0 0 0 0 1 1 1
0 1 0 0 1 1 0 0 0 0 0
0 1 0 0 0 0 1 0 0 0 0
0 0 0 1 0 0 1 0 0 0 1
0 0 0 0 0 1 1 0 0 1 0